111111111111111
110C10000000001
111010000000C11
110000111110011
11P001100E00011
111111111111111